7 7
    0    4    6    0    0    0    0
    0    0    0    0    0    0    3
    0    0    0    0    6    0    3
    4    2    0    0    0    0    0
    0    5    0    2    0    0    0
    0    5    0    1    0    0    0
    0    0    0    0    0    0    1
