7 7
    0    0    0    0    0    0    3
    0    0    0    6    0    0    0
    0    0    0    0    0    0    5
    6    0    2    4    3    0    5
    4    0    0    0    0    2    1
    0    1    0    0    0    0    0
    0    0    0    0    0    0    0
