7 7
    0    0    0    0    0    0    6
    6    4    0    0    0    0    0
    0    0    0    0    4    5    0
    3    0    1    0    0    5    0
    0    0    0    0    0    0    0
    0    3    0    0    0    0    0
    0    0    1    2    2    0    0
