7 7
    0    0    2    3    3    6    6
    0    0    0    0    0    0    0
    2    0    0    0    0    0    0
    0    0    4    0    0    5    0
    1    0    0    0    0    0    0
    0    0    0    0    1    4    0
    0    0    0    0    0    5    0
