7 7
    3    0    0    0    0    2    0
    5    3    0    0    0    0    0
    0    0    0    0    0    0    0
    0    0    0    0    0    0    0
    0    0    0    0    2    0    6
    0    0    5    0    0    6    1
    4    0    0    0    0    4    1
