7 7
    0    0    0    0    0    0    2
    0    0    0    0    0    0    0
    6    0    0    0    0    0    0
    6    0    0    0    0    0    0
    0    5    3    3    0    4    2
    0    0    0    0    0    4    1
    5    0    0    0    0    0    1
