7 7
    0    0    0    6    0    0    4
    0    3    0    0    0    0    0
    0    0    0    0    0    0    0
    0    0    0    0    0    6    0
    0    0    0    5    0    4    0
    3    1    0    2    1    2    0
    5    0    0    0    0    0    0
