7 7
    5    5    0    0    0    0    3
    2    2    0    0    6    0    0
    1    0    0    1    6    0    0
    0    0    0    0    0    0    0
    0    3    4    0    0    0    0
    0    0    0    0    0    0    0
    4    0    0    0    0    0    0
