7 7
    0    0    4    2    6    3    3
    4    0    0    0    0    0    0
    0    0    0    0    0    0    1
    0    0    5    0    0    0    0
    5    0    2    0    0    0    0
    0    0    0    0    0    0    0
    6    0    0    0    0    1    0
