7 7
    0    0    1    0    4    0    0
    0    0    0    0    0    0    0
    1    0    0    0    0    5    5
    4    0    0    0    0    0    2
    6    0    3    2    0    0    0
    0    0    0    0    0    0    0
    0    0    6    3    0    0    0
