7 7
    1    3    0    0    0    0    3
    0    0    0    0    0    0    0
    0    0    0    0    6    0    0
    0    0    1    6    0    0    5
    2    0    2    0    5    0    0
    4    0    0    0    4    0    0
    0    0    0    0    0    0    0
