7 7
    1    0    0    0    0    0    2
    1    0    0    0    0    0    0
    0    0    0    0    2    0    0
    0    0    0    0    5    3    0
    0    5    0    0    6    4    0
    0    0    0    0    0    0    3
    6    0    0    0    0    0    4
