7 7
    5    0    0    0    0    0    0
    4    0    0    0    0    2    5
    0    0    0    0    1    0    0
    0    0    4    0    3    6    2
    0    0    0    0    0    0    0
    0    0    0    0    0    0    0
    1    0    3    0    0    0    6
