7 7
    4    4    0    3    0    0    0
    0    0    0    0    0    0    0
    0    0    3    0    0    0    0
    5    5    0    0    0    0    0
    0    0    1    0    0    0    0
    0    0    0    0    6    2    0
    1    0    0    0    6    2    0
