7 7
    3    0    0    0    4    0    0
    3    0    0    0    0    0    0
    0    0    1    6    6    0    0
    0    0    0    0    0    0    0
    0    0    0    0    0    0    0
    2    0    1    0    0    0    0
    2    0    5    0    5    4    0
