7 7
    0    0    2    0    4    0    4
    3    0    0    0    2    0    1
    3    0    0    0    0    0    0
    6    1    0    0    0    0    0
    0    0    0    0    0    0    0
    0    0    0    0    0    0    0
    0    0    5    0    0    5    6
