7 7
    0    0    4    0    0    3    3
    1    0    0    4    0    0    0
    1    0    0    0    0    5    2
    5    0    0    0    0    0    0
    6    0    0    0    0    0    0
    0    2    6    0    0    0    0
    0    0    0    0    0    0    0
