7 7
    0    0    0    6    4    0    2
    0    0    0    0    4    0    0
    0    0    6    0    0    0    0
    0    0    0    0    0    0    0
    0    0    0    0    0    0    0
    3    1    0    1    0    0    0
    5    0    5    3    0    2    0
