7 7
    5    5    4    0    4    0    0
    1    0    0    0    0    0    6
    0    0    0    0    0    0    0
    0    1    6    0    0    0    0
    0    3    0    0    0    0    0
    0    0    0    0    0    0    0
    2    0    2    0    0    0    3
