7 7
    5    0    0    0    0    3    3
    0    0    0    6    0    1    1
    0    0    0    0    0    0    0
    0    0    0    0    0    0    0
    0    0    6    4    0    0    0
    0    0    5    4    0    2    0
    0    0    0    2    0    0    0
