7 7
    0    0    0    0    0    0    6
    0    0    0    0    0    1    0
    1    3    3    0    0    0    0
    0    0    0    0    0    0    6
    0    0    0    0    0    0    0
    0    0    0    0    5    4    4
    2    2    0    0    5    0    0
