7 7
    0    0    0    3    0    0    0
    0    0    0    0    0    3    0
    0    0    0    0    6    0    0
    0    0    0    0    0    4    4
    0    0    2    6    0    0    0
    0    0    0    0    0    0    0
    2    5    5    1    1    0    0
