7 7
    2    0    0    0    0    0    1
    0    0    0    0    6    6    0
    4    0    0    5    3    0    0
    0    0    0    0    0    0    0
    0    5    2    0    0    0    0
    0    0    0    0    3    0    0
    0    4    1    0    0    0    0
