9 9
    8    0    0    0    0    0    0    0    2
    0    0    8    0    0    0    0    0    0
    0    0    0    0    4    0    0    0    0
    0    0    0    0    0    0    0    0    0
    0    0    6    2    0    0    0    0    0
    0    0    6    3    7    0    0    0    0
    4    0    3    0    0    5    0    1    1
    7    0    0    0    0    0    0    0    0
    0    0    0    0    0    0    5    0    0
