9 9
    0    0    0    0    0    8    4    1    0
    0    0    0    0    0    4    0    1    0
    0    0    0    0    0    0    8    7    7
    0    0    0    5    5    0    0    0    0
    0    0    0    0    0    0    0    0    0
    0    0    0    3    0    0    0    0    0
    0    0    0    0    0    0    0    0    2
    0    0    0    0    3    0    2    0    0
    0    0    0    0    0    0    0    6    6
