9 9
    0    0    0    0    0    0    5    0    0
    0    6    0    0    0    0    0    0    0
    0    0    0    0    0    0    0    2    0
    0    0    0    0    0    0    2    0    0
    0    0    0    0    0    0    0    0    0
    0    0    0    0    4    5    0    0    0
    0    0    0    0    0    3    3    0    0
    0    0    0    0    0    1    1    8    8
    6    0    0    0    4    7    0    0    7
