9 9
    6    0    0    0    0    0    0    0    0
    0    0    0    0    0    0    0    0    0
    1    5    1    0    0    0    0    0    0
    0    0    0    0    0    0    0    0    6
    0    0    0    0    0    3    0    0    0
    0    2    0    0    0    0    0    8    3
    0    0    5    7    0    0    0    0    0
    0    0    0    0    0    2    0    7    0
    0    0    0    0    0    4    4    8    0
