9 9
    0    1    5    0    0    0    0    0    5
    0    0    0    0    1    0    0    0    0
    0    0    0    0    0    0    4    0    6
    0    8    0    6    0    0    0    0    2
    0    0    0    0    0    0    0    0    0
    0    0    0    7    4    0    2    0    0
    0    0    0    0    0    0    0    0    0
    0    0    0    0    0    0    0    0    0
    0    8    0    0    0    7    3    0    3
