9 9
    5    0    0    0    0    0    0    0    6
    0    0    0    0    0    0    0    0    0
    7    0    0    0    0    0    0    5    0
    2    0    0    0    0    7    0    1    0
    0    0    0    0    0    0    0    0    0
    1    2    0    0    0    0    8    0    6
    0    0    0    0    0    0    0    0    0
    0    0    0    0    0    0    0    4    4
    3    3    0    0    0    0    0    0    8
