9 9
    0    0    0    3    0    0    5    6    0
    0    0    0    7    0    5    0    0    0
    0    1    0    0    0    0    0    0    0
    0    0    0    0    0    0    4    8    0
    0    0    0    0    0    0    0    0    6
    0    0    0    0    0    0    0    0    0
    1    3    0    0    0    0    0    0    0
    0    0    0    0    0    0    0    0    0
    0    0    7    0    4    2    0    2    8
