9 9
    7    0    0    4    0    0    0    0    6
    8    7    0    0    5    0    0    0    0
    0    0    0    0    0    0    0    5    0
    0    3    0    0    0    0    0    6    0
    0    0    0    0    4    1    0    0    0
    0    0    0    0    3    0    0    2    0
    0    0    8    0    0    0    0    0    0
    0    0    0    0    0    0    0    0    0
    0    0    0    2    0    0    0    0    1
