8 8
    0    0    0    0    0    0    0    1
    2    7    0    0    0    3    0    1
    5    5    7    2    0    0    0    0
    0    0    0    0    0    0    0    0
    6    6    0    0    0    0    0    0
    0    0    3    0    0    0    0    0
    0    0    4    0    0    0    0    4
    0    0    0    0    0    0    0    0
