8 8
    0    0    0    0    0    0    0    0
    0    7    0    0    0    0    0    0
    7    5    0    0    0    0    0    4
    6    3    0    0    0    0    0    0
    0    0    0    0    0    0    0    0
    0    0    5    0    4    1    0    0
    0    0    0    2    1    0    0    0
    6    3    0    0    0    2    0    0
