8 8
    3    0    0    0    0    1    4    4
    0    0    7    0    0    0    0    0
    0    0    0    2    1    0    0    0
    0    7    0    0    0    0    0    0
    0    6    0    0    0    0    0    0
    0    0    0    0    6    0    0    0
    0    0    5    0    3    0    0    0
    0    0    0    0    0    0    5    2
