8 8
    0    0    0    0    0    0    0    0
    0    0    0    1    5    0    0    0
    3    0    0    3    4    0    0    0
    2    0    0    0    0    0    0    0
    0    0    0    0    0    0    5    0
    7    0    0    6    0    0    0    0
    0    0    6    2    0    4    0    0
    0    0    0    0    0    7    1    0
