8 8
    0    0    0    0    0    0    5    3
    5    0    0    0    0    2    0    0
    2    0    0    0    0    0    0    0
    0    0    0    4    0    1    1    0
    0    6    0    6    0    0    0    0
    0    0    0    0    0    0    0    0
    0    0    0    0    0    7    0    0
    0    0    7    0    0    4    0    3
