8 8
    1    0    0    0    0    0    0    1
    4    0    0    0    0    0    0    4
    6    0    0    0    0    0    0    0
    6    5    2    0    0    0    0    0
    0    0    0    7    0    0    0    5
    3    0    0    7    0    2    0    0
    0    0    0    0    0    0    0    0
    0    0    0    0    0    3    0    0
