8 8
    4    4    0    0    0    0    0    0
    0    0    0    7    7    0    0    0
    0    0    0    0    0    0    0    0
    0    0    0    0    0    0    0    0
    0    0    0    0    3    0    0    5
    0    0    0    2    5    0    0    0
    0    0    0    0    0    0    0    0
    3    0    0    2    1    1    6    6
