8 8
    1    1    0    0    0    0    0    5
    0    0    0    5    0    0    0    0
    0    0    0    0    0    0    0    0
    0    0    6    0    0    0    0    4
    7    0    0    0    2    6    0    0
    3    0    0    0    0    0    0    0
    0    7    2    0    0    0    0    0
    3    4    0    0    0    0    0    0
