8 8
    0    7    0    0    0    0    0    6
    0    0    0    0    0    1    0    0
    0    0    3    0    3    1    0    0
    0    0    0    0    0    0    0    0
    0    0    0    0    0    0    0    0
    0    7    6    0    0    0    0    4
    2    2    0    0    0    0    0    4
    5    0    0    0    0    0    0    5
