8 8
    7    0    0    0    0    0    0    4
    0    0    0    0    0    0    0    0
    6    1    0    7    3    0    0    0
    0    0    6    5    3    0    0    0
    0    1    0    0    0    0    0    0
    0    0    0    0    0    0    0    0
    0    0    0    0    0    0    2    0
    5    0    0    4    0    0    0    2
