8 8
    0    0    0    0    3    5    0    0
    0    3    1    0    7    0    4    0
    2    1    0    0    0    0    5    4
    0    0    0    0    7    2    0    0
    0    0    0    0    0    0    0    0
    0    0    0    0    0    0    0    0
    0    0    0    0    0    0    6    0
    0    0    0    6    0    0    0    0
