8 8
    0    6    5    4    0    0    0    0
    0    6    0    4    0    0    0    0
    7    0    0    0    0    0    0    0
    0    0    5    0    0    0    0    0
    0    0    1    0    0    1    0    0
    7    0    0    0    0    0    0    0
    0    0    3    0    0    0    0    2
    3    0    0    0    0    0    0    2
