8 8
    0    0    0    0    0    0    0    0
    0    0    0    6    1    0    0    0
    0    5    0    2    0    0    2    1
    0    0    0    0    0    0    0    7
    0    0    0    0    0    7    3    0
    6    0    0    0    0    0    0    0
    5    0    4    0    3    0    0    4
    0    0    0    0    0    0    0    0
