8 8
    1    0    7    7    0    0    0    0
    0    0    0    0    0    0    0    0
    0    0    0    0    0    0    0    0
    0    0    0    0    0    0    6    2
    0    5    0    0    0    0    0    0
    0    0    0    5    0    0    3    0
    0    0    0    4    2    0    0    0
    1    4    0    0    3    0    0    6
