8 8
    5    0    0    0    3    3    0    0
    0    0    0    0    0    0    4    0
    0    0    0    0    0    0    0    0
    2    0    6    5    0    4    0    0
    0    0    0    0    6    7    7    0
    0    0    0    0    0    0    0    0
    0    2    0    0    0    0    0    1
    0    0    0    0    0    1    0    0
