8 8
    0    0    6    0    6    0    5    2
    0    0    0    0    7    0    0    0
    0    0    0    0    0    0    0    0
    0    7    0    0    0    0    0    0
    1    0    0    0    0    0    0    2
    0    0    0    0    0    0    0    0
    0    4    0    1    5    4    0    0
    0    0    0    0    0    0    3    3
