8 8
    0    0    0    0    5    0    0    7
    0    0    0    0    0    0    0    7
    0    0    0    0    0    0    0    0
    0    0    1    3    5    0    0    0
    0    0    1    6    0    0    0    0
    0    0    0    0    0    0    0    6
    0    3    4    0    0    0    0    0
    0    0    0    0    4    0    2    2
