8 8
    2    0    0    0    0    0    0    1
    0    0    0    0    6    6    0    1
    2    5    5    0    0    0    0    0
    0    0    7    0    0    0    0    0
    0    4    0    0    0    0    0    0
    0    0    0    3    0    0    7    0
    0    0    0    0    0    0    0    0
    4    0    0    0    0    0    0    3
