8 8
    0    0    0    0    0    0    5    1
    0    0    0    0    2    1    0    0
    7    0    5    0    0    0    3    3
    7    0    0    0    0    0    0    0
    0    0    0    0    6    0    0    0
    0    0    0    0    4    0    6    0
    0    0    0    0    0    0    0    0
    2    0    0    0    0    0    0    4
