6 6
    4    4    0    0    0    0
    0    0    0    0    0    0
    2    1    0    0    0    2
    1    0    0    0    0    0
    0    0    0    0    5    5
    0    0    0    3    0    3
