6 6
    0    0    0    0    5    3
    0    0    0    0    0    0
    0    0    5    0    2    0
    4    4    2    0    0    0
    0    0    0    0    3    1
    1    0    0    0    0    0
