6 6
    1    0    0    0    0    5
    0    0    0    0    0    0
    0    1    2    0    5    0
    0    0    0    0    0    0
    0    0    4    3    0    0
    2    0    4    3    0    0
