6 6
    0    0    0    0    2    4
    0    2    1    0    0    0
    3    3    0    0    0    0
    0    0    0    0    0    0
    0    5    1    0    0    0
    0    0    5    4    0    0
