6 6
    2    2    5    0    0    4
    0    0    0    0    0    0
    0    0    0    0    0    4
    3    0    0    0    0    5
    0    0    0    0    0    0
    0    0    3    1    0    1
