6 6
    1    0    0    0    0    2
    3    3    0    0    0    0
    0    0    0    0    0    0
    0    0    0    5    1    2
    0    0    0    0    0    4
    0    0    5    4    0    0
