6 6
    0    0    0    0    0    2
    0    0    3    0    0    1
    5    2    0    0    1    3
    0    0    0    0    0    0
    0    0    0    0    0    0
    0    0    0    5    4    4
