6 6
    0    0    2    3    5    0
    0    0    0    0    0    0
    0    4    0    0    0    0
    0    0    1    2    3    5
    0    0    0    0    0    0
    0    0    0    0    4    1
