6 6
    2    2    5    0    0    0
    1    0    0    0    0    0
    0    0    0    0    0    5
    0    0    0    3    4    0
    1    0    0    0    0    0
    3    0    0    0    0    4
