6 6
    3    0    0    0    0    0
    0    0    0    0    0    0
    0    1    0    0    0    4
    0    0    0    0    0    0
    2    1    0    0    5    4
    2    3    0    0    0    5
