6 6
    0    2    2    0    0    4
    0    0    0    0    0    0
    3    0    5    1    4    0
    0    0    0    0    0    0
    0    0    0    0    0    0
    3    0    0    0    5    1
