6 6
    5    0    4    0    4    0
    0    0    3    0    0    0
    0    0    0    0    0    0
    0    0    0    1    0    0
    0    0    0    0    0    1
    5    0    3    0    2    2
