6 6
    1    0    0    5    0    0
    1    0    0    0    0    0
    2    3    3    5    4    0
    0    0    0    0    0    0
    0    0    0    4    0    0
    0    0    0    0    0    2
