6 6
    0    1    0    0    0    0
    0    0    0    0    0    2
    1    0    0    0    0    0
    0    0    0    3    4    0
    0    0    0    0    0    3
    5    0    5    2    0    4
