6 6
    1    1    2    0    0    2
    0    0    0    0    3    0
    0    0    0    0    0    0
    0    0    0    3    0    0
    0    0    0    5    4    4
    0    0    0    0    0    5
