6 6
    5    0    0    0    0    3
    5    0    0    0    0    0
    0    0    4    3    1    0
    2    2    0    1    0    0
    0    0    0    4    0    0
    0    0    0    0    0    0
