6 6
    0    5    1    0    3    3
    0    5    0    0    0    0
    0    0    0    0    0    0
    0    0    2    4    2    0
    0    0    0    0    0    4
    0    0    0    0    0    1
