6 6
    5    4    0    3    0    3
    0    0    0    0    0    0
    5    0    1    4    2    0
    2    1    0    0    0    0
    0    0    0    0    0    0
    0    0    0    0    0    0
