6 6
    0    0    0    0    0    0
    0    0    0    2    0    0
    2    3    0    0    0    0
    0    0    0    0    4    4
    3    0    0    0    0    0
    5    0    1    0    1    5
