6 6
    1    3    0    0    0    2
    1    0    2    0    0    0
    5    0    3    0    0    0
    5    0    0    4    0    0
    4    0    0    0    0    0
    0    0    0    0    0    0
