6 6
    1    0    0    1    0    5
    2    4    0    0    0    0
    0    0    4    0    0    0
    0    0    0    0    0    0
    0    0    0    5    3    0
    0    0    0    2    3    0
