6 6
    2    0    5    0    0    4
    0    0    0    4    0    0
    0    0    0    0    3    0
    0    0    0    0    0    0
    0    0    0    3    0    1
    2    5    1    0    0    0
