6 6
    1    0    0    5    0    4
    2    1    0    0    0    0
    0    0    0    0    0    0
    2    0    0    0    0    0
    3    5    4    0    0    0
    0    3    0    0    0    0
