6 6
    4    4    0    5    2    0
    0    0    0    0    0    0
    1    0    0    0    0    0
    0    0    1    0    0    0
    0    3    3    0    0    0
    0    0    0    5    2    0
