6 6
    3    0    0    0    0    0
    0    5    1    0    4    3
    0    2    0    0    0    0
    0    0    0    1    0    0
    0    0    0    0    0    0
    5    0    0    2    4    0
