5 5
    4    0    0    0    0
    2    2    3    0    0
    0    0    3    0    0
    0    1    0    0    4
    0    0    0    0    1
