5 5
    1    0    4    0    3
    2    1    0    0    0
    2    3    0    4    0
    0    0    0    0    0
    0    0    0    0    0
