5 5
    1    0    0    0    0
    0    0    0    0    0
    0    0    2    4    4
    0    0    3    0    3
    1    0    2    0    0
