5 5
    3    0    0    0    4
    0    0    0    0    2
    3    1    0    0    0
    0    0    0    0    0
    0    1    4    0    2
