5 5
    0    0    0    0    3
    0    0    3    2    2
    0    1    1    0    4
    0    0    0    0    0
    4    0    0    0    0
