5 5
    0    0    0    0    0
    0    3    0    0    3
    1    2    0    0    0
    0    0    0    0    0
    1    2    4    0    4
