5 5
    3    0    0    0    4
    2    0    0    0    0
    0    0    0    3    0
    0    0    0    2    4
    1    0    0    0    1
