5 5
    0    3    3    4    1
    0    0    0    0    0
    0    0    4    0    0
    0    2    2    1    0
    0    0    0    0    0
