5 5
    4    0    0    3    1
    0    0    0    0    0
    0    0    0    0    1
    4    2    0    0    3
    2    0    0    0    0
