5 5
    3    0    0    0    0
    0    1    1    2    2
    0    0    0    0    4
    0    0    4    3    0
    0    0    0    0    0
