5 5
    2    0    0    0    1
    0    1    0    0    0
    0    2    4    4    0
    3    3    0    0    0
    0    0    0    0    0
