5 5
    4    0    0    4    3
    1    3    0    0    0
    0    0    0    0    0
    0    2    0    2    1
    0    0    0    0    0
