5 5
    2    1    0    0    1
    2    0    0    0    0
    3    0    0    0    0
    0    0    4    3    0
    0    0    0    0    4
