5 5
    2    3    4    0    0
    0    0    1    0    4
    0    0    0    0    0
    0    2    0    1    0
    0    0    0    0    3
