5 5
    2    0    0    0    1
    3    2    0    0    1
    0    0    0    0    0
    4    3    0    0    0
    0    0    0    0    4
