5 5
    0    0    0    0    1
    0    0    0    0    2
    1    0    0    0    2
    0    0    0    3    0
    4    4    0    3    0
