5 5
    0    0    1    4    2
    0    1    4    0    0
    0    0    0    0    0
    0    3    0    0    0
    0    0    3    2    0
