5 5
    1    4    4    0    0
    0    0    0    0    0
    0    0    0    0    3
    2    0    0    3    0
    0    2    1    0    0
