5 5
    0    0    0    0    0
    0    0    0    3    3
    1    1    2    4    0
    0    0    0    0    0
    2    0    0    0    4
