5 5
    0    0    2    3    3
    2    0    4    0    0
    0    0    0    0    0
    0    0    0    0    0
    4    0    1    0    1
