5 5
    4    0    0    0    0
    0    0    1    3    0
    4    0    2    0    0
    0    0    0    0    0
    0    2    0    3    1
