5 5
    0    0    1    0    1
    0    0    0    0    3
    0    0    0    0    0
    0    3    2    0    0
    4    4    2    0    0
