5 5
    3    0    0    0    0
    0    4    3    2    4
    0    0    0    0    0
    1    0    0    2    0
    1    0    0    0    0
