5 5
    1    0    2    0    2
    4    0    1    0    0
    0    0    0    0    0
    0    0    4    3    0
    3    0    0    0    0
