5 5
    3    3    0    0    0
    0    0    0    1    1
    2    0    0    2    4
    0    0    0    0    0
    0    0    0    0    4
