5 5
    3    3    0    0    2
    0    0    0    4    0
    0    0    0    0    0
    0    0    1    4    0
    1    0    0    2    0
