5 5
    0    0    0    0    1
    1    2    4    0    0
    0    0    0    0    0
    0    3    3    2    0
    0    0    0    0    4
