5 5
    0    0    0    0    0
    1    0    0    0    0
    0    0    3    0    0
    0    3    0    0    0
    1    4    4    2    2
