5 5
    4    0    0    0    0
    0    2    2    1    0
    0    0    0    0    0
    0    0    1    0    4
    3    0    0    0    3
