5 5
    3    0    0    0    0
    0    2    1    2    0
    0    0    0    0    4
    0    0    0    4    1
    0    3    0    0    0
