5 5
    3    2    0    0    4
    0    0    0    0    0
    3    2    4    0    0
    1    0    0    0    0
    0    0    1    0    0
