5 5
    3    0    3    4    2
    0    0    0    0    0
    0    0    0    0    0
    0    1    4    0    0
    0    1    0    0    2
