5 5
    2    1    3    0    3
    2    0    0    4    0
    1    0    0    0    0
    0    0    0    0    4
    0    0    0    0    0
