5 5
    2    0    0    2    3
    0    0    1    0    0
    0    0    0    0    0
    0    0    0    0    0
    4    4    1    0    3
