5 5
    2    0    2    1    0
    0    4    1    0    0
    0    0    4    3    3
    0    0    0    0    0
    0    0    0    0    0
